RRRRRRRRRRRRRRRRRRRRRRRR
RNNNNNNNNNNNNNNNNNNNNNNR
RNNNNNNNNNRNNNRNNNNNNNNR
RNNNNNNNNRNNNNNRNNNNNNNR
RNNNNNNNRNNNNNNNRNNNNNNR
RNNNNNNRNNNNNNNNNRNNNNNR
RNNNNNRNNNNNNNNNNNRNNNNR
RNNANRNNNNNNNNNNNNNRNNNR
RNNNNNNNNNNNNNNNNNNNNNNR
RNNNNNNNNSNNNNNNNNNNNNNR
RNNNNRNNNNNNNNNNNNNRNNNR
RNNNNNRNNNNNNNNNNNRNNNNR
RNNNNNNRNNNNNNNNNRNNNNNR
RNNNNNNNRNNNNNNNRNNNNNNR
RNNNNNNNNRNNNNNRNNNNNNNR
RNNNNNNNNNRNNNRNNNNNNNNR
RNNNNNNNNNNNNNNNNNNNNNNR
RNNNNNNNNNNNNNNNNNNNNNNR
RRRRRRRRRRRRRRRRRRRRRRRR