NNNNNNNNNNNNNNNNNNNNNNNN
NNNRRRRRNNNNNNNNRRRRRNNN
NNNRNNNRNNNNNNNNRNNNRNNN
NNNRNNNRNNNNNNNNRNNNRNNN
NNNRNNNRNNNNNNNNRNNNRNNN
NNNRNNNRNNNNNNNNRNNNRNNN
NNNNNNNNNNNNNNNNNNNNNNNN
NNNNNNNNNNNNNNNNNANNNNNN
NNNNNNNNNNNNNNNNNNNNNNNN
NNNNNNNNNNNNNNNNNNNNNNNN
NNNNNNNNSNNNNNNNNNNNNNNN
NNNNNNNNNNNNNNNNNNNNNNNN
NNNRNNNRNNNNNNNNRNNNRNNN
NNNRNNNRNNNNNNNNRNNNRNNN
NNNRNNNRNNNNNNNNRNNNRNNN
NNNRNNNRNNNNNNNNRNNNRNNN
NNNRRRRRNNNNNNNNRRRRRNNN
NNNNNNNNNNNNNNNNNNNNNNNN