RRRNNNNNNNNNNNNNNNNNNRRR
RNNNNNNNNNNNNNNNNNNNNNNR
RNNNNNSNNNNNNNNNNNNNNNNR
RNNNNNNNNNNNNNNNNNNNNNNR
RNNNNNNNNNNNNNNNNNNNNNNR
RNNNNNNNNNNNNNNNNNNNNNNR
RNNNNNNNNNNNNNNNNNNNNNNR
RNNANNNNNNNNNNNNNNNNNNNR
RNNNNNNNNNNNNNNNNNNNNNNR
RNNNNNNNNNNNNNNNNNNNNNNR
RNNNNNNNNNNNNNNNNNNNNNNR
RNNNNNNNNNNNNNNNNNNNNNNR
RNNNNNNNNNNNNNNNNNNNNNNR
RNNNNNNNNNNNNNNNNNNNNNNR
RNNNNNNNNNNNNNNNNNNNNNNR
RNNNNNNNNNNNNNNNNNNNNNNR
RNNNNNNNNNNNNNNNNNNNNNNR
RRRNNNNNNNNNNNNNNNNNNRRR