NNNNNNNNNNNNNNNNNNNNNNNN
NNNNNNSNNNNNNNNNNNNNNNNN
NNRRRRRRRRRRRRRRRRRRRRNN
NNRNNNNNNNNNNNNNNNNNNRNN
NNRNRRRRRRRRRRRRRRRRNRNN
NNRNRNNNNNNNNNNNNNNRNRNN
NNRARNRRRRRRRRRRRRNRNRNN
NNRNRNRNNNNNNNNNNRNRNRNN
NNRNRNRNNNNNNNNNNRNRNRNN
NNRNRNRNRRRRRRRRRRNRNRNN
NNRNRNRNNNNNNNNNNNNRNRNN
NNRNRNRRRRRRRRRRRRRRNRNN
NNRNRNNNNNNNNNNNNNNNNRNN
NNRNRRRRRRRRRRRRRRRRRRNN
NNRNNNNNNNNNNNNNNNNNNNNN
NNRRRRRRRRRRRRRRRRRRRRNN
NNNNNNNNNNNNNNNNNNNNNNNN
NNNNNNNNNNNNNNNNNNNNNNNN