NNNNNNNNNNNNNNNNNNNNNNNN
NNNRRRRRNNNNNNNNRRRRRNNN
NNNRNNNNNNNNNNNNNNNNRNNN
NNNRNNNNNNNNNNNNNNNNRNNN
NNNRNNNNNNNNNNNNNNNNRNNN
NNNRNNNNNNNNNNNNNNNNRNNN
NNNNNNNNNNNNNNNNNNNNNNNN
NNNNNNNNNNNNNNNNNANNNNNN
NNNNNNNNNNNNNNNNNNNNNNNN
NNNNNNNNNNNNNNNNNNNNNNNN
NNNNNNNNSNNNNNNNNNNNNNNN
NNNNNNNNNNNNNNNNNNNNNNNN
NNNRNNNNNNNNNNNNNNNNRNNN
NNNRNNNNNNNNNNNNNNNNRNNN
NNNRNNNNNNNNNNNNNNNNRNNN
NNNRNNNNNNNNNNNNNNNNRNNN
NNNRRRRRNNNNNNNNRRRRRNNN
NNNNNNNNNNNNNNNNNNNNNNNN