RRRRRRRRRRRRRRRRRRRRRRRR
RNNNNNNNNNNNNNNNNNNNNNNR
RNRNNNNNNNNNNNNNNNNNNRNR
RNNRNNNNNNNNNNNNNNNNRNNR
RNNNRNNNNNNNNNNNNNNRNNNR
RNNNNRNNNNNNNNNNNNRNNNNR
RNNNNNRNNNNNNNNNNRNNNNNR
RNNNNNNNANNNNNNNNNNNNNNR
RNNNNNNNNNNNNNNNNNNNNNNR
RNNNNNNNNNNNNNNNNNNNNNNR
RNNNNNNNNNNNNNNNSNNNNNNR
RNNNNNRNNNNNNNNNNRNNNNNR
RNNNNRNNNNNNNNNNNNRNNNNR
RNNNRNNNNNNNNNNNNNNRNNNR
RNNRNNNNNNNNNNNNNNNNRNNR
RNRNNNNNNNNNNNNNNNNNNRNR
RNNNNNNNNNNNNNNNNNNNNNNR
RRRRRRRRRRRRRRRRRRRRRRRR