NNNNNNNNNNNNNNNNNNNNNNNN
NNRNNNRNNNRNNNRNNNRNNNRN
NNNNNNNNNNNNNNNNNNNNNNNN
NNNNNNNNNNNNNNNNNNNNNNNN
NNRNNNRNNNRNNNRNNNRNNNRN
NNNNNNNSNNNNNNNNNNNANNNN
NNNNNNNNNNNNNNNNNNNNNNNN
NNRNNNRNNNRNNNRNNNRNNNRN
NNNNNNNNNNNNNNNNNNNNNNNN
NNNNNNNNNNNNNNNNNNNNNNNN
NNRNNNRNNNRNNNRNNNRNNNRN
NNNNNNNNNNNNNNNNNNNNNNNN
NNNNNNNNNNNNNNNNNNNNNNNN
NNRNNNRNNNRNNNRNNNRNNNRN
NNNNNNNNNNNNNNNNNNNNNNNN
NNNNNNNNNNNNNNNNNNNNNNNN
NNRNNNRNNNRNNNRNNNRNNNRN
NNNNNNNNNNNNNNNNNNNNNNNN