RRRRRRRRRRRRRRRRRRRRRRRR
RNNNNNNNNNNNNNNNNNNNNNNR
RNRRRRRNNNNNNNNNRRRRRRNR
RNRNNNNNNNNNNNNNNNNNNRNR
RNRNNNNNNNNNNNNNNNNNNRNR
RNRNNNNNNNNNNNNNNNNNNRNR
RNRNNNNNNNNNNNNNNNNNNRNR
RNNANNNNNNNNNNNNNNNNNNNR
RNNNNNNNNNNNNNNNNNNNNNNR
RNNNNNNNNNSNNNNNNNNNNNNR
RNNNNNNNNNNNNNNNNNNNNNNR
RNRNNNNNNNNNNNNNNNNNNRNR
RNRNNNNNNNNNNNNNNNNNNRNR
RNRNNNNNNNNNNNNNNNNNNRNR
RNRNNNNNNNNNNNNNNNNNNRNR
RNRRRRRRNNNNNNNNRRRRRRNR
RNNNNNNNNNNNNNNNNNNNNNNR
RRRRRRRRRRRRRRRRRRRRRRRR