NNNNNNNNNNNNNNNNNNNNNNNN
NNNNNNNNNNNNNNNNNNNNNNNN
NNRNNNNNNRNNNNRNNNNNNRNN
NNNRNNNNRNNNNNNRNNNNRNNN
NNNNRNNRNNNNNNNNRNNRNNNN
NNNNNRRNNNNNNNNNNRRNNNNN
NNNNNNNNNNNNNNNNNNNNNNNN
NNNNNNNNANNNNNNNNNNNNNNN
NNNNNNNNNNNNNNNNNNNNNNNN
NNNNNNNNNNNNNNNNNNNNNNNN
NNNNNNNNNNNNNNNNSNNNNNNN
NNNNNNNNNNNNNNNNNNNNNNNN
NNNNNRRNNNNNNNNNNRRNNNNN
NNNNRNNRNNNNNNNNRNNRNNNN
NNNRNNNNRNNNNNNRNNNNRNNN
NNRNNNNNNRNNNNRNNNNNNRNN
NNNNNNNNNNNNNNNNNNNNNNNN
NNNNNNNNNNNNNNNNNNNNNNNN